#####B##############
##### ##############
####  ##############
#### ###############
####       #########
########## #########
########## #########
##########    ######
############# ######
##########    ######
########## #########
##########   #######
############ #######
############       #
################## #
################   #
################ ###
################   #
################## #
##################A#